wwwwwwwwwwwwwwwwwwwwwwwwwwwwwwwwwwwwwwww
w                  w                   w
w                  w                   w
w                  w                   w
w                  w                   w
w                  w                   w
w                  w     w             w
w                  w     w             w
w                  w    w              w
w                  wwwww               w
w                  w                   w
w                  w                   w
w                  w                   w
w                  w                   w
w                  w                   w
w                                      w
w                                      w
w                                      w
wwwwwwwww                              w
w                                      w
w                                      w
w                                      w
w                                      w
w                                      w
w                                 w    w
w                                  w   w
w                                   w  w
w                                    w w
w                                      w
wwwwwwwwwwwwwwwwwwwwwwwwwwwwwwwwwwwwwwww